
original: 0.4

1 5 2 5 6 9 3 0 2 0 
2 5 1 6 5 7 9 1 4 6 
9 4 7 0 8 1 6 0 8 5 
1 1 8 0 1 5 6 5 5 4 
1 6 3 1 8 0 3 4 1 1 
7 7 1 6 2 8 5 6 6 6 
6 2 5 7 3 4 1 9 9 1 
9 5 9 5 5 5 9 7 0 5 
2 8 8 8 2 7 0 9 1 6 
7 5 5 6 0 0 0 3 6 6 
9 2 1 3 4 7 1 3 0 5 
0 7 7 5 1 3 3 8 9 7 
6 9 0 5 8 7 7 2 0 1 
5 9 2 6 6 5 4 3 3 5 
8 1 2 5 5 7 1 5 7 4 
5 5 9 3 9 1 0 9 2 8 

downgraded: 0.1625

1 5 2 5 6 9 3 0 2 0 
2 9 1 6 5 7 9 1 4 6 
9 4 7 1 8 1 0 0 8 5 
1 0 8 0 1 5 6 0 5 4 
5 6 3 1 8 0 3 4 1 5 
7 0 1 6 2 8 5 0 6 2 
6 2 5 7 3 4 1 9 6 1 
9 5 9 5 9 5 9 7 0 5 
2 8 3 8 2 7 6 9 1 6 
7 7 5 6 5 7 5 3 6 6 
9 2 1 3 4 7 1 3 0 5 
0 5 7 5 1 3 8 8 9 7 
6 3 0 1 8 7 7 2 0 1 
5 5 2 9 6 5 4 3 6 5 
8 1 6 1 5 7 1 5 7 4 
5 5 9 3 9 1 0 9 2 8 
