
original: 1.05

7 5 3 3 2 4 4 2 2 9 
7 5 3 5 2 6 0 0 7 7 
2 3 3 5 4 4 4 1 8 2 
2 3 9 9 4 6 8 3 8 9 
9 2 4 3 3 6 8 3 8 9 
0 2 4 9 5 4 6 6 8 3 
0 8 8 9 5 4 2 0 0 3 
5 5 9 2 1 1 2 4 4 9 
5 5 9 2 3 5 3 8 8 8 
3 1 6 7 7 5 7 7 9 8 
3 6 6 0 0 3 3 8 8 1 
9 6 1 0 1 1 5 5 9 1 
3 3 1 4 4 2 0 0 6 0 
3 3 7 3 2 2 9 9 6 0 
1 8 7 3 6 9 8 2 2 8 
1 8 0 1 1 9 8 3 3 8 

downgraded: 0.8875

7 5 3 3 4 4 4 2 2 9 
7 5 3 6 2 6 8 0 7 7 
2 3 3 5 3 4 4 1 8 2 
2 4 6 9 4 9 8 3 8 9 
9 2 4 3 3 6 8 0 8 9 
0 2 4 9 5 2 6 6 8 3 
0 0 8 9 5 4 2 0 0 3 
5 5 9 2 1 1 0 4 4 9 
5 5 9 2 3 5 3 8 8 8 
3 1 6 7 7 5 7 7 9 8 
3 6 6 0 0 3 3 8 8 1 
9 5 1 2 1 1 5 5 9 1 
3 3 1 4 4 2 0 0 6 3 
3 3 7 3 2 2 9 9 6 0 
1 8 7 3 6 9 8 2 2 8 
1 8 0 1 1 9 8 3 3 8 
