
original: 0.5625

2 0 2 6 8 8 0 8 5 1 
8 7 5 0 0 0 0 2 5 7 
7 8 8 6 4 6 2 4 3 7 
2 1 8 9 7 8 5 2 6 7 
5 6 6 6 6 9 7 7 7 7 
3 5 3 5 1 0 0 8 9 2 
3 3 6 3 7 1 9 7 3 2 
8 6 7 1 0 4 7 9 7 6 
9 8 6 7 0 4 7 9 2 9 
2 7 7 0 5 4 4 9 9 0 
8 1 7 1 4 1 1 5 7 6 
8 5 5 6 9 3 5 5 4 3 
3 7 4 4 6 4 2 3 8 5 
2 7 3 7 6 5 8 6 0 0 
0 3 7 9 6 1 8 7 8 8 
6 3 0 6 7 3 3 4 5 7 

downgraded: 0.1875

2 0 2 6 7 8 0 8 5 1 
8 7 5 0 0 3 7 2 5 7 
7 9 9 6 4 6 2 4 3 3 
2 1 8 9 7 8 5 2 6 7 
5 2 6 5 6 9 8 7 8 0 
7 5 3 5 1 7 0 8 9 2 
8 3 6 3 7 1 9 7 3 6 
8 6 7 1 0 4 7 8 7 6 
9 8 6 7 0 5 7 9 2 9 
2 7 0 0 5 8 4 8 9 0 
3 1 7 1 4 1 1 6 7 6 
7 5 5 6 9 3 4 0 4 3 
3 7 4 4 6 4 2 3 8 5 
2 7 3 7 3 5 6 6 5 0 
0 8 7 9 6 1 8 7 8 4 
6 3 0 6 7 0 3 4 5 7 
