
original: 0.475

1 9 8 4 9 0 1 2 4 1 
2 6 0 4 3 0 7 5 5 0 
0 7 1 1 4 3 2 1 1 4 
1 1 8 8 5 7 2 9 9 9 
6 2 0 2 2 1 5 4 4 8 
2 3 0 3 6 5 3 0 4 8 
9 4 0 4 3 9 3 6 4 7 
5 4 2 7 5 8 6 7 1 7 
0 3 5 7 5 0 7 0 0 2 
2 2 3 5 9 4 1 1 4 1 
6 0 0 4 7 3 6 7 4 2 
8 7 1 5 5 8 7 9 1 3 
1 1 7 4 2 6 2 7 9 3 
9 7 3 0 0 4 9 4 1 3 
4 7 2 9 4 7 9 4 1 4 
1 5 7 4 9 9 7 5 1 0 

downgraded: 0.15

1 9 8 3 9 4 1 2 4 1 
2 6 0 4 3 0 7 2 5 0 
0 7 0 1 4 3 1 4 1 4 
1 4 8 7 5 7 2 9 1 9 
6 2 0 3 2 1 5 0 5 7 
2 3 4 3 6 5 3 0 9 8 
9 4 1 4 3 9 3 6 4 7 
5 1 2 8 2 8 6 7 1 0 
0 3 5 7 5 0 7 9 0 2 
0 5 3 5 9 4 1 4 1 1 
6 0 7 4 7 3 6 7 4 2 
8 7 1 5 5 8 7 9 1 3 
1 4 7 4 2 6 2 7 9 2 
9 7 3 0 0 4 9 4 1 2 
4 8 2 9 4 7 1 4 9 4 
1 5 7 4 9 0 7 5 1 0 
