
original: 0.625

7 8 4 4 3 8 8 3 8 6 
7 1 8 6 1 1 5 8 7 7 
6 6 9 7 7 6 6 0 0 0 
6 8 5 8 9 9 2 3 8 1 
6 5 2 3 0 0 2 7 7 3 
4 5 2 0 2 3 1 0 3 8 
4 2 6 3 2 4 5 4 5 0 
9 2 2 9 0 1 1 0 8 5 
1 1 8 4 4 0 2 9 6 8 
2 4 8 6 0 6 3 9 6 6 
8 1 0 6 0 5 4 4 8 6 
8 8 3 6 0 2 0 7 6 8 
0 0 7 3 7 8 0 3 1 8 
0 1 4 1 0 9 8 3 1 2 
0 4 3 2 3 0 6 5 4 9 
1 9 3 1 7 0 6 5 5 5 

downgraded: 0.4

7 8 4 5 3 8 8 3 8 6 
7 1 8 6 1 1 5 8 0 7 
0 6 9 9 7 6 6 0 0 6 
4 8 5 8 9 9 2 3 8 1 
6 3 7 3 7 0 2 2 0 3 
4 5 2 0 2 3 1 0 3 8 
0 2 6 3 2 4 5 4 5 0 
9 2 2 9 0 1 1 0 8 5 
1 1 8 4 4 0 2 7 6 8 
2 4 8 5 0 6 3 9 6 6 
8 1 0 6 0 5 4 4 8 6 
0 8 3 6 0 2 0 7 6 8 
0 8 7 3 7 8 7 3 0 8 
6 1 4 1 0 9 8 3 1 2 
1 4 3 2 3 0 6 5 4 9 
1 9 5 1 7 0 6 6 5 4 
