
original: 0.95

1 5 1 3 8 6 6 1 1 3 
1 8 0 3 0 0 2 2 8 7 
8 8 8 3 2 5 9 9 8 8 
8 7 7 1 0 5 9 8 1 0 
0 8 1 6 5 6 4 7 1 8 
0 1 1 1 5 6 4 6 4 0 
4 1 7 1 1 6 0 9 4 0 
2 9 6 0 0 6 8 8 5 2 
6 6 5 5 7 8 8 8 6 5 
8 1 0 0 2 9 1 2 8 6 
8 1 9 9 6 7 7 9 8 6 
7 2 2 2 6 3 3 4 0 0 
7 9 2 6 1 7 7 4 4 8 
5 0 2 4 4 8 8 8 1 1 
8 0 6 6 9 3 6 6 6 8 
8 1 6 6 9 3 6 6 1 1 

downgraded: 0.6

1 5 1 3 8 6 6 1 1 3 
1 8 0 0 0 0 2 2 8 7 
8 8 8 3 2 5 9 9 5 8 
8 7 6 1 0 8 9 8 1 0 
0 8 1 6 5 1 6 7 1 8 
8 1 4 1 5 6 4 6 4 0 
4 1 7 6 1 6 0 9 4 0 
2 9 6 0 0 6 8 8 5 2 
6 6 2 5 7 8 8 8 6 5 
8 1 3 0 2 9 1 2 8 6 
8 1 0 9 6 7 7 9 8 6 
7 2 5 2 6 3 3 4 0 8 
6 9 2 6 1 7 7 4 4 8 
5 9 2 4 4 8 0 8 1 1 
8 0 6 6 9 3 1 7 6 8 
0 1 7 1 9 3 6 6 6 1 
