
original: 1.2

7 5 5 9 9 9 9 0 0 8 
7 9 8 8 0 0 8 3 0 8 
0 0 2 2 9 9 8 3 0 3 
0 0 3 0 0 3 2 5 5 3 
1 1 3 2 2 3 6 8 4 4 
1 0 1 1 5 5 6 8 0 5 
1 7 7 2 2 9 9 9 0 5 
9 9 9 6 0 5 6 4 4 1 
9 7 7 6 0 5 6 4 6 1 
9 7 7 3 3 5 7 4 6 0 
6 6 9 9 1 5 7 6 6 0 
1 1 0 2 1 7 7 3 3 7 
9 9 0 2 3 7 7 0 0 7 
0 0 5 5 3 5 8 2 0 0 
8 3 6 7 7 5 8 8 9 9 
8 3 6 0 1 1 9 8 9 9 

downgraded: 1

7 5 5 9 5 9 9 0 0 8 
7 9 8 8 0 0 8 3 0 8 
0 9 2 2 9 9 8 3 0 3 
0 0 3 0 0 3 2 5 5 3 
0 1 3 2 2 3 6 8 4 4 
1 0 1 1 5 5 6 8 0 5 
1 7 7 2 2 9 9 0 0 5 
9 9 9 6 0 5 6 4 4 1 
9 0 7 6 0 5 6 4 6 1 
9 7 7 3 3 7 7 4 6 3 
6 6 9 9 1 5 7 6 6 0 
1 1 7 2 1 7 5 3 3 7 
9 9 0 2 0 7 7 0 1 7 
0 0 9 5 3 5 8 2 0 0 
8 3 6 7 7 5 8 8 9 9 
8 3 6 0 1 1 9 8 9 9 
