
original: 0.5625

5 5 6 5 7 6 5 8 8 0 
8 5 0 1 5 5 0 2 8 1 
1 1 3 1 3 7 2 5 5 6 
3 6 2 7 3 0 7 5 2 3 
4 3 3 7 8 3 3 6 0 3 
4 3 1 7 4 8 0 7 7 3 
0 5 1 3 9 9 6 8 8 4 
9 9 5 9 4 7 6 9 5 4 
1 8 2 1 5 7 1 8 5 0 
4 1 1 8 9 6 6 3 0 4 
4 6 8 1 8 4 4 7 3 8 
2 2 5 1 1 6 8 1 6 9 
2 6 9 7 6 0 0 7 1 5 
8 7 6 1 8 6 0 4 4 3 
3 8 1 6 6 6 6 1 5 5 
7 8 9 4 0 7 8 3 0 5 

downgraded: 0.3

5 3 6 5 7 6 5 8 8 0 
8 3 0 1 1 5 0 2 3 1 
4 1 3 5 7 7 2 2 5 6 
3 6 2 7 3 0 7 5 2 3 
1 3 8 3 8 5 3 6 0 3 
4 3 1 7 4 8 0 8 7 5 
0 5 1 3 9 9 6 8 7 4 
9 0 5 9 4 2 6 9 5 4 
1 8 2 1 5 7 1 8 5 0 
4 1 1 8 9 6 6 3 0 4 
4 6 8 1 8 4 4 7 3 8 
8 7 5 1 1 6 8 1 6 9 
5 6 9 7 6 0 9 7 1 5 
8 7 6 1 8 6 0 4 6 3 
3 8 1 6 6 4 6 1 5 5 
7 2 9 4 0 7 8 3 0 5 
