
original: 0.825

6 8 4 4 2 2 2 2 1 1 
1 6 3 3 5 0 3 3 1 9 
1 5 5 3 4 3 0 9 7 7 
9 4 0 7 5 3 4 1 3 0 
9 4 4 4 3 4 2 8 8 8 
2 2 9 0 8 2 0 6 2 5 
9 7 0 0 3 2 2 6 3 8 
9 7 3 9 9 2 2 2 6 6 
9 7 3 8 0 0 2 8 2 3 
5 1 9 0 7 1 1 8 4 2 
5 5 8 7 2 1 2 2 3 2 
2 8 3 2 6 6 0 2 7 1 
3 5 5 8 7 6 0 5 7 6 
8 8 0 8 7 6 6 2 1 9 
1 8 7 2 7 7 6 3 5 3 
1 8 7 0 0 3 6 8 7 7 

downgraded: 0.5

6 8 4 4 2 2 7 2 1 1 
1 6 3 6 5 0 3 3 1 9 
1 5 7 3 4 2 0 9 7 7 
9 4 0 7 5 3 4 1 3 0 
9 9 4 4 3 4 2 8 8 8 
2 2 9 0 8 2 0 6 2 5 
9 7 7 0 3 0 5 6 3 8 
9 7 3 9 9 6 3 2 6 6 
4 7 3 8 2 0 0 8 2 3 
5 1 9 0 7 7 1 8 4 7 
5 5 8 7 2 1 2 2 3 2 
2 8 3 2 2 6 0 0 7 1 
3 2 5 1 7 6 2 5 2 6 
8 8 0 8 1 3 6 2 1 9 
1 8 5 2 2 7 6 3 5 3 
8 8 7 0 2 3 6 8 0 7 
