
original: 1

9 9 6 7 9 2 5 9 0 9 
0 5 6 7 9 2 0 9 5 9 
0 5 4 4 6 2 0 1 1 1 
5 6 3 1 7 5 5 5 5 3 
5 4 4 1 7 1 1 6 6 3 
3 8 9 7 7 6 6 5 6 0 
2 8 9 5 5 9 3 3 1 5 
2 1 1 1 0 1 2 2 5 5 
1 3 5 3 0 1 7 2 2 2 
1 3 5 0 0 8 8 0 0 0 
6 3 3 4 3 3 3 8 3 5 
7 9 9 6 0 9 5 5 9 5 
8 7 5 6 0 4 4 7 9 5 
2 2 8 3 0 4 0 0 1 2 
4 1 8 6 8 8 0 9 1 2 
4 2 2 6 6 6 0 9 8 8 

downgraded: 0.7

9 2 6 7 9 2 5 9 0 9 
0 1 6 7 6 5 0 9 5 9 
1 5 4 0 6 9 0 3 1 0 
5 6 3 1 7 5 5 5 5 3 
5 4 4 9 7 1 1 6 6 1 
3 8 9 7 7 1 6 5 6 0 
2 0 9 5 5 9 3 4 1 5 
2 3 1 1 0 1 2 2 5 5 
1 3 5 3 3 5 7 2 2 2 
1 3 5 1 0 8 8 0 0 0 
6 3 3 4 3 0 3 8 3 5 
7 9 9 9 0 9 2 5 9 5 
8 7 5 6 0 4 4 7 9 5 
2 2 8 3 0 4 8 0 1 2 
4 1 8 6 8 8 2 9 6 2 
4 0 2 6 6 6 0 1 8 8 
