
original: 1.1875

6 2 4 6 4 3 9 9 5 5 
1 2 4 2 7 4 4 4 5 5 
1 0 0 2 7 3 3 4 1 1 
5 5 7 7 3 0 0 7 9 8 
6 2 7 7 3 4 5 7 7 8 
0 2 9 9 2 2 7 5 7 8 
0 6 7 7 2 2 7 3 3 8 
6 6 3 5 5 8 8 8 0 1 
1 1 7 7 7 8 3 6 6 1 
1 1 0 7 6 6 9 5 5 6 
2 9 0 3 3 3 3 3 4 0 
2 7 2 2 3 3 4 4 5 5 
6 7 2 6 6 2 9 3 6 5 
5 1 1 2 2 2 9 3 6 6 
6 7 7 3 3 4 9 3 3 6 
6 5 5 3 3 6 6 3 3 2 

downgraded: 0.8

6 2 4 6 4 3 9 9 5 5 
8 2 4 2 7 4 4 2 5 5 
1 0 0 2 7 3 3 4 1 1 
5 5 7 7 3 0 0 7 9 8 
6 2 7 7 3 4 5 7 7 8 
0 2 9 3 2 2 7 5 7 3 
9 6 3 7 2 2 7 3 6 8 
6 6 3 7 5 8 1 8 0 1 
1 1 7 4 7 8 3 3 6 3 
1 1 0 7 6 2 9 5 5 6 
7 9 0 3 1 3 3 3 4 0 
2 7 2 2 3 3 4 4 5 5 
6 5 2 6 6 2 9 3 6 5 
5 1 5 2 6 0 2 3 6 6 
6 7 7 3 3 4 9 9 3 6 
6 5 1 3 8 6 6 7 3 2 
